3 3 3 3 3 3 3 3 3 3 3 3 3 3 3 3 3 3 3 3 3 3 3 3 3 
3 0 0 0 0 3 0 0 1 0 0 1 6 1 0 0 1 0 0 3 0 0 0 0 3 
3 1 0 0 0 3 0 1 0 0 0 1 1 1 0 0 0 1 0 3 0 0 0 1 3 
3 0 1 0 0 0 1 0 0 0 0 0 0 0 0 0 0 0 1 0 0 0 1 0 3 
3 0 0 1 3 1 0 0 0 3 0 0 0 0 0 3 0 0 0 1 3 1 0 0 3 
3 0 0 1 1 1 0 0 0 1 3 0 0 0 3 1 0 0 0 1 1 1 0 0 3 
3 5 0 1 1 1 0 5 0 1 1 1 1 1 1 1 0 5 0 1 1 1 0 5 3 
3 0 0 1 3 1 0 0 0 1 3 0 0 0 3 1 0 0 0 1 3 1 0 0 3 
3 0 1 0 0 0 1 0 0 3 0 0 0 0 0 3 0 0 1 0 0 0 1 0 3 
3 1 0 0 0 0 0 1 0 0 1 0 0 0 1 0 0 1 0 0 0 0 0 1 3 
3 0 0 0 0 0 0 0 1 0 0 1 0 1 0 0 1 0 0 0 0 0 0 0 3 
3 3 3 0 0 1 3 3 1 0 0 0 3 0 0 0 1 3 3 1 0 0 3 3 3 
3 0 0 0 0 0 0 0 1 0 0 1 0 1 0 0 1 0 0 0 0 0 0 0 3 
3 1 0 0 0 0 0 1 0 0 1 0 0 0 1 0 0 1 0 0 0 0 0 1 3 
3 0 1 0 0 0 1 0 0 3 0 0 0 0 0 3 0 0 1 0 0 0 1 0 3 
3 0 0 1 3 1 0 0 0 1 3 0 0 0 3 1 0 0 0 1 3 1 0 0 3 
3 4 0 1 1 1 0 4 0 1 1 1 1 1 1 1 0 4 0 1 1 1 0 4 3 
3 0 0 1 1 1 0 0 0 1 3 0 0 0 3 1 0 0 0 1 1 1 0 0 3 
3 0 0 1 3 1 0 0 0 3 0 0 0 0 0 3 0 0 0 1 3 1 0 0 3 
3 0 1 0 0 0 1 0 0 0 0 0 0 0 0 0 0 0 1 0 0 0 1 0 3 
3 1 0 0 0 3 0 1 0 0 0 1 1 1 0 0 0 1 0 3 0 0 0 1 3 
3 0 0 0 0 3 0 0 1 0 0 1 2 1 0 0 1 0 0 3 0 0 0 0 3 
3 3 3 3 3 3 3 3 3 3 3 3 3 3 3 3 3 3 3 3 3 3 3 3 3